X X X X X
E E E E N
E E E E N
E E E E N
N N N N N